21100000000000000000
00111111110000000000
00100100011111110000
01100100000000010000
01000111110001110000
01000000001111110000
01100000000100000000
00100000000111100000
01100000000000111100
00100011111111100000
00111100011000000000
00001000001000000000
00001110001111000000
00000010000001110000
00011110000000010000
00110000000111110000
00100000000100000000
00111100000111100000
00000111110000100000
00011100010000111100
00010000010011100113
